WWWWWWWWWWWWWWWWWWWW
WSSSSSSWSSSSWSSZSSSW
WWWWWWLWSSSSWLWWWWWW
WSGSSSLWSSSSWLSSSSSW
WWWWWWLSSSSSSLSSSSSC
WSSSSWWWWWWWWWWWWWLW
WSSSGWSSSSSSSSSSSWLW
WLWWWWSSSWSSZSSSSSLW
WLWSSSSSSWWWWWWLWWWW
WLSSSSSSSSSSSSSLWSSW
WWWWWWWWWWWLWWWWWSSW
WSSSSSSSSSWLWSSSSSSW
WSSSSSSSSSWLWSSSSSSW
WGSSSSSSSSSLSSSPSSSW
WWWWWWWWWWWWWWWWWWWW