WWWWWWWWWWWWWWWWWWWW
WSZSGSWSSWSSSSSSSGSC
WLWWWLWSSWWLWWVVWWWW
WLSSSLSSSWSLSSSSSSSW
WWWWWWLWWWWWWWLVVVVW
WSESSVLSSSSSSSLSSSSW
WWWWWWWWWWWWVWWWWWLW
WGSSSSWSSWSSSSSGSSLW
WVVVVLSSSSLWWWWWWWWW
WSSSVVLWWWWWWVVVVVVW
WSSSSWLWSSSWSSSSSSSW
WSSSSSLSSSSISSSSGSSW
WWWWWWWWLWWWWWWWWWWW
WPSSSSSSLSSSSSSSVSZW
WWWWWWWWWWWWWWWWWWWW