WWWWWWWWWWWWWWWWWWWW
WGSSSSSSSSSSSSSSSSGW
WWWWWLWWSSSSWWLWWWWW
WSSSSLSSSSSSSSLSSSSC
WSSSSLSSSSSSSSLSSSSW
WSSSSLSSSSSSSSLSSSSW
WSSSSLSSSSSSSSLSSSSW
WSSSSLSSSSSSSSLSSSSW
WSSSWLSSSEESSSLWSSSW
WSSSWLWWWWWWWWLWSSSW
WSSSSLSSSSSSSSLSSSSW
WSSSSLSSSSSSSSLSSSSW
WSSSSLSSSSSSSSLSSSSW
WPSSSLSSSSHSSSLSSSSW
WWWWWWWWWWWWWWWWWWWW