WWWWWWWWWWWWWWWWWWWW
WSGSSSWSSSSSSWSSSGSW
WWWWWLWSSSSSSWLWWWWW
WGSVSLWSSSSSSWLSVSGC
WWWWWLWSSSSSSWLWWWWW
WGSGSLWSSISSSWLSGSGW
WWWWWLWSSSSSSWLWWWWW
WESVSLWSSSSSSWLSVSGW
WWWWWLWSSSSSSWLWWWWW
WSGSSLWSSSSSSWLSSGSW
WWWWWLWSSSSSSWLWWWWW
WGSVSLWSYSSYSWLSVSGW
WWWWWLWSSSSSSWLWWWWW
WGSVSLSSSPSSSSLSVSGW
WWWWWWWWWWWWWWWWWWWW