WWWWWWWWWWWWWWWWWWWW
WSSSGSSWSSSSSSSSSSSW
WWWWWWLWSSSSSSSSSSSW
WSGSSSLWSSSSSSISSSSW
WWWWWWLSSSSSSSSSSSSC
WSSSSWWWWWWWWWWWWWLW
WSSSGWSSSSSSSSSSSWLW
WLWWWWSSSWSSSSSSSSLW
WLWSSSSSSWWWWWWLWWWW
WLSSSPSSSSSSSSSLWSSW
WWWWWWWWWWWLWWWWWSSW
WSSSSSSSSSWLWSSSSSSW
WSSSSSSSSSWLWSSASSSW
WGSSSSSSSSSLSSSSSSSW
WWWWWWWWWWWWWWWWWWWW