WWWWWWWWWWWWWWWWWWWW
WSGSGSWSSWSSSSSSSGSC
WLWWWLWSSWWLWWVVWWWW
WLSSSLSSSWSLSSSSSSSW
WWWWWWLWWWWWWWLVVVVW
WSGSSVLSSSSSSSLSSSSW
WWWWWWWWWWWWVWWWWWLW
WGSSSSWSSWSSSSSGSSLW
WVVVVLSSSSLWWWWWWWWW
WSSSVVLWWWWWWVVVVVVW
WSSSSWLWSSSWSSSSSSSW
WSSSSSLSSSSSSSSSGSSW
WWWWWWWWLWWWWWWWWWWW
WPSSSSSSLSSSSSSSVSGW
WWWWWWWWWWWWWWWWWWWW