WWWWWWWWWWWWWWWWWWWW
WSSSSSHSSSSSSSSSSSLC
WSSSSSSSSSSSSSSSSSLW
WSSSSSSSSSSSSSSSSSLW
WSSSSSSSSSSSSSSSSSLW
WSSSSSSSSSSSSSSSSSLW
WSSSSSSSSSSSSSSSSSLW
WSSSSSSSSSSSSSSSSSLW
WSSSSSSSSSSSSSSSSSLW
WSSSSSSSSSSSSSSSSSLW
WSSSSSSSSSSSSSSSSSLW
WSSSSSSSSSSSSSSSSSLW
WSSSSSSSSSSSSSSSSSLW
WPSGGGGGGGGGGGGGGGLW
WWWWWWWWWWWWWWWWWWWW