WWWWWWWWWWWWWWWWWWWW
WSSSSEWSSSSSSSSSSSSW
WVLWWWVSASSSWWWWWWWW
WVLSSSSSSSSSVSSSSSSC
WVLVWWWWWVVVWWWWWWWW
WVLVSSSSSISSSSSSSSSW
WVLVSSYSSSSSSYSSSSSW
WVLVSSSSSSSSSSSASSSW
WVLGSSSSWSSWSSSSGSSW
WVWWWWLWWSSWWLWWWVVW
WSSSSVLVSSSSVLVWWWWW
WSSSSVLVSYYSVLVSESSW
WSSSSVLVSSSSVLVWWLWW
WPSSSSLSZSSZSLSSSLSW
WWWWWWWWWWWWWWWWWWWW