WWWWWWWWWWWWWWWWWWWW
WSSSSSSSSSSSSSGWSSSW
WLWWWWWWWWWWWLWWSSSW
WLWSSSSSSSSSWLSSESSC
WLWSSSSSSSSSWLWWWWWW
WLWSSSSSSSSSWLSSSSSW
WLWSSSSSSSSSWLSSSSSW
WLWSSSSSSSSSWLSSSSSW
WLWSSSSSWSSSSLSSSHSW
WLWWSYSSWMMMMMMMMMMW
WLSSSSSSSBSSSSSSSSSW
WLSESSWSSBSSSSSSSSSW
WWWWWLWSSBSSSSASSSSW
WPSSSLSSSVSSSSSSSSGW
WWWWWWWWWWWWWWWWWWWW