WWWWWWWWWWWWWWWWWWWW
WSSSSSSWGSGWSSSSSSSW
WSSSSSSWWLWWSSSSSSSW
WSSSSSSSSLSSSSSZSSSC
WSSZSSSSSLSSSSSSSSSW
WSSSSSSSSLSSSSSZSSSW
WSSZSSSSSLSSSSSSSSSW
WSSSSSSSSLSSSSSZSSSW
WSSZSSSSSLSSSSSSSSSW
WSSSSSSSSLSSSSSZSSSW
WSSZSSSSSLSSSSSSSSSW
WSSSSSSSSLSSSSSZSSSW
WSSZSSSSSLSSSSSSSSSW
WPSSSSSSSLSSSSSSSSSW
WWWWWWWWWWWWWWWWWWWW