WWWWWWWWWWWWWWWWWWWW
WSSSSGWSSWSSSSZSSSSW
WVLWWWVSAWLWWWWWWWWW
WVLSSSSSSSLSVSSSSSSC
WVLVWWWWWVVVWWWWWWWW
WVLVSSSSSSSSSSSSSSSW
WVLVSSSSSSSSSSSSSSSW
WVLVSSSSSSSSSSSASSSW
WVLGSSSZWSSWZSSSGSSW
WVWWWWLWWSSWWLWWWVVW
WSSSSVLVSSSSVLVWWWWW
WSSSSVLVSSSSVLVSGSSW
WSSSSVLVSSSSVLVWWLWW
WPSSSSLSSSSSSLSSSLSW
WWWWWWWWWWWWWWWWWWWW