WWWWWWWWWWWWWWWWWWWW
WSSSSSSSSSSSSSSSSSSW
WSSSSSSSSSSSSSSSSSSW
WSSSSSSSSLSSSSSSSSSC
WSSSSSSSSLSSSSSSSSSW
WSSSSSSSSLSSSSSSSSSW
WSSSSSSSSLSSSSSSSSSW
WSSSSSSSSLSSSSSSSSSW
WSSSZSSSSLSSSSSSSSSW
WSSSSSSSSLSSSSSSSSSW
WSSSSSSSSLSSSSSSSSSW
WSSSSSSSSLSSSYSYSYSW
WSSSSSSSSLSSSSSSSSSW
WPSSSSSSSLSSSSSSSSSW
WWWWWWWWWWWWWWWWWWWW