WWWWWWWWWWWWWWWWWWWW
WSSSSSHSSSSSSSSSSSLC
WSSSSSSSSSSSSSSSSSLW
WSSSSSSSSSSSSSSSSSLW
WSSSSSSSSSSZSSSSSSLW
WSSSSSSSSSSSSSSSSSLW
WSSSSSSSSSSSSSSSSSLW
WSSSSSSSSSSSSSSSSSLW
WSSSSZSSSSSSSSSSSSLW
WSSSSSSSSSSSSSSSSSLW
WSSSSSSSSSSSSSSSSSLW
WSSSSSSYSSSZSSSSSSLW
WSSSSSSSSSSSSSSSSSLW
WPSGGGGGGGGGGGGGGGLW
WWWWWWWWWWWWWWWWWWWW