WWWWWWWWWWWWWWWWWWWW
WSSSSSSSSSSSSSSSSSSW
WSSSSSSSSSSSSSSSSSSW
WSSSSSSSSSSSSSSSSSSW
WSSSSSSSSSSSSSSSSSSW
WSSSSSSSSISSSSSSSSSW
WSSSSSSSSSSSSSSSSSSW
WSSSSSSSSSSSSSSSSSSW
WSSSSSSSSSSSSSSSSSSW
WSSSSSSSSSSSSSSSSSSW
WSSSSSSSSSSSSSSSSSSW
WSYSYSYSYSYSYSYSYSSW
WSSSSSSSSSSSSSSSSSSW
WPSSSSSSSSSSSSSSSSSC
WWWWWWWWWWWWWWWWWWWW