WWWWWWWWWWWWWWWWWWWW
WSSHSVSSSSSSSSSSSSLC
WWWWWWSSSSSSSSSSSWLW
WSHSSVSSSSSSSSSSSSLW
WWWWWWSSSSSSSSSSSWLW
WSSSHVSSSSSSSSSSSSLW
WWWWWWSSSSSSSSSSSWLW
WHSSSVSSSSSSSSSSSSLW
WWWWWWSSSSSSSSSSSWLW
WSSHSVSSSSSSSSSSSSLW
WWWWWWSSSSSSSSSSSWLW
WSHSSVSSYSYSYSYSYSLW
WWWWWWSSSSSSSSSSSWLW
WPSSSSSSSSSSSSSSSSLW
WWWWWWWWWWWWWWWWWWWW