WWWWWWWWWWWWWWWWWWWW
WPSSGSSWSSSSSSSSSSSW
WWWWWWLWSSSSSSSSSSSW
WSGSSSLWSSSSSSSSSSSW
WWWWWWLSSSSSSSHSSSSW
WSSSSWWWWWWWWWWWWWLW
WSSSGWSSSSSSSSWSSWLW
WLWWWWSSSSSSSSWSSSLW
WLWSSSSSSSSSSSWLWWWW
WLSSSSHSSSSSSSSLWSSW
WWWWWWWWWWWLWWWWWSSW
WSSSSSSSSSWLWSSSSSSW
WSSASSSSSSWLWSSSASSW
WGSSSSSSSSSLSSSSSSSC
WWWWWWWWWWWWWWWWWWWW