WWWWWWWWWWWWWWWWWWWW
WSSSSSSWESEWSSSSSSSW
WSSSSSSWWLWWSSSSSSSW
WSSSSSSSSLSSSSSZSSSC
WSSZSSSSSLSSSSSSSSSW
WSSSSSISSLSSSSSZSSSW
WSSZSSSSSLSSSSSSSSSW
WSSSSSSSSLSSSSSZSSSW
WSSZSSSSSLSSSSSSSSSW
WSSSSSSSSLSSSSSZSSSW
WSSZSSSSSLSSSSSSSSSW
WSSSSSSSSLSSSSSZSSSW
WSSZSSSSSLSSSSSSSSSW
WPSSSSSSSLSSSSSSSSSW
WWWWWWWWWWWWWWWWWWWW