WWWWWWWWWWWWWWWWWWWW
WSSSSGWSSSSSSSSSSSSW
WVLWWWVSASSSWWWWWWWW
WVLSSSSSSSSSVSSSSSSC
WVLVWWWWWVVVWWWWWWWW
WVLVSSSSSSSSSSSSSSSW
WVLVSSSSSSSSSSSSSSSW
WVLVSSSSSSSSSSSASSSW
WVLGSSSSWSSWSSSSGSSW
WVWWWWLWWSSWWLWWWVVW
WSSSSVLVSSSSVLVWWWWW
WSSSSVLVSSSSVLVSGSSW
WSSSSVLVSSSSVLVWWLWW
WPSSSSLSSSSSSLSSSLSW
WWWWWWWWWWWWWWWWWWWW