WWWWWWWWWWWWWWWWWWWW
WSSSSSSSSSSSSSSSSSSW
WWWWWLWWSSSSWWLWWWWW
WSSSSLSSSSSSSSLSSSSC
WSSSSLSSSSSSSSLSSSSW
WSSSSLSSSSSSSSLSSSSW
WSSSSLSSSSSSSSLSSSSW
WSSSSLSSSSSSSSLSSSSW
WSSSWLSSSEESSSLWSSSW
WSSSWLWWWWWWWWLWSSSW
WSSSSLSSSSSSSSLSSSSW
WSSSSLSSSSSSSSLSSSSW
WSSSSLSSSSSSSSLSSSSW
WPSSSLSSSSSSSSLSSSSW
WWWWWWWWWWWWWWWWWWWW