WWWWWWWWWWWWWWWWWWWW
WSSSSGWSSSSSSSSSSSSW
WVLWWWVSASSSWWWWWWWW
WVLSSSSSSSSSVSSSSSSC
WVLVWWWWWVVVWWWWWWWW
WVLVSSSSSSSSSSSSSSSW
WVLVSSYSSSSSSYSSSSSW
WVLVSSSSSSSSSSSASSSW
WVLGSSSSWSSWSSSSGSSW
WVWWWWLWWSSWWLWWWVVW
WSSSSVLVSSSSVLVWWWWW
WSSSSVLVSYYSVLVSGSSW
WSSSSVLVSSSSVLVWWLWW
WPSSSSLSZSSZSLSSSLSW
WWWWWWWWWWWWWWWWWWWW