WWWWWWWWWWWWWWWWWWWW
WSGSSSWSSSSSSWSSSGSW
WWWWWLWSSSSSSWLWWWWW
WGSVSLWSSSSSSWLSVSGC
WWWWWLWSSSSSSWLWWWWW
WGSGSLWSSSSSSWLSGSGW
WWWWWLWSSSSSSWLWWWWW
WESVSLWSSSSSSWLSVSGW
WWWWWLWSSSSSSWLWWWWW
WSGSSLWSSSSSSWLSSGSW
WWWWWLWSSSSSSWLWWWWW
WGSVSLWSYSSYSWLSVSGW
WWWWWLWSSSSSSWLWWWWW
WGSVSLSSSPSSSSLSVSGW
WWWWWWWWWWWWWWWWWWWW