WWWWWWWWWWWWWWWWWWWW
WSPSSSSSSSGSSSSSSSSW
WWWWWWWWWWWWWWWWWWLW
WSSSSSSSSVVSSSSSSSLW
WLWWWWWWWWWWWWWWWWWW
WLSSSSSSSGGSSSSSSSSW
WWWWWWWWWWWWWWWWWWLW
WWWWWWWSSSSSSWLSVSLW
WWWWWWWSSSSSSWLWWWWW
WSGSSSWSSSSSSWLSSGSW
WWWWWLWSSSSSSWLWWWWW
WGSVSLWSYSSYSWLSVSGW
WWWWWLWSSSSSSWLWWWWW
CSSESLSSSSSSSSLSVSGW
WWWWWWWWWWWWWWWWWWWW